1111111111111111111111111111111111111
1000000000000000000000000000000000001
1000000000000000000000000000000000001
1000000000000000000000000000000000001
1000000000000000000000000000000100011
1000000000000000000000000000001100001
1000000000000000000000000000000100001
1000000000000000000000000000000100001
1000000000000000000000000000000100001
1000000000000000000000000000000100001
1000000000000000000000000000000100001
1000000000000000000000000000000100001
1000000000000000000000000000000100001
1000000000000000000000000000000100001
1000000000000000000000000000000100001
1000000000000000000W00111110000000001
1010010010000010100100100010000010101
1010001010101000100100100010000010101
1P00000000000000000000111110000111111
1000000000000000000000000000000111111
1111111111111111111111111111111111111